1111111111111
10E100N0000C1
100100C0000C1
100100C00NNC1
100000C0000C1
100100C00P0C1
1111111111111